__XXX_XXX_____
____XXX_______
_XXXX_XXX_XXX_
_______X____X_
XXXX___XX_____
X___________X_
X_XXXXXXXX_XXX
__X___________
__X____XXX____
__XXXXXX_____X
______X______X
__XXXXX______X
_____________X