__XXX_XXX____
_____________
_XXXX_XXX_XXX
____________X
XXXX________X
X___________X
X_XXXXXXXX_XX
__X__________
__X____X_____
__X____X_____
_____________
__XXXXX______
_____________